100 100 100 100 100 100 100 100 100 100 100 100 100 102 103 104
100 101 101 101 101 101 101 101 100 101 101 101 100 105 106 107
100 101 101 100 100 101 101 101 100 101 101 101 100 105 106 107
100 101 100 100 100 100 101 100 100 101 101 101 100 105 106 107
100 101 100 101 101 101 101 101 100 100 101 100 100 105 106 107
100 101 100 100 100 100 100 101 100 101 101 101 100 105 106 107
100 101 101 101 101 101 100 101 100 101 101 101 100 105 106 107
100 100 100 100 100 101 100 101 100 100 101 100 100 105 106 107
100 101 101 101 101 101 101 101 101 101 101 101 100 105 106 107
100 101 100 100 100 100 100 100 100 100 100 101 100 105 106 107
100 101 101 100 101 101 100 101 101 100 101 101 100 105 106 107
100 101 101 101 101 101 100 101 101 101 101 101 100 105 106 107
100 100 100 100 100 100 100 100 100 100 100 100 100 108 109 110
