0 0 0 0 0 0 0 0 0 0 0 0 0 0 0 0
0 1008 0 1001 1001 0 0 10 0 1001 12 0 0 0 0 0
0 1 0 1001 1001 0 0 0 0 0 0 1000 0 0 0 0
0 0 0 0 13 0 0 0 1002 0 16 0 0 0 0 0
0 0 1000 1000 0 1000 0 0 1012 0 0 11 0 0 0 0
0 0 0 0 0 0 0 0 0 0 0 0 0 0 0 0
0 0 0 13 10 0 1001 0 16 17 0 0 0 0 0 0
0 0 0 0 0 0 0 0 0 0 0 0 0 0 0 0
0 10 0 0 1011 0 0 1000 1000 0 1000 0 0 0 0 0
0 0 11 0 1005 0 0 0 0 13 0 13 0 0 0 0
0 1000 0 0 0 0 0 0 0 0 0 0 0 0 0 0
0 0 12 0 0 16 0 0 1002 1002 0 1007 0 0 0 0
0 0 0 0 0 0 0 0 0 0 0 0 0 0 0 0