0 0 0 0 0 0 0 0 0 0 0 0 0 0 0 0
0 1007 0 1004 0 0 1012 0 0 1001 0 12 0 0 0 0
0 0 0 1002 0 0 0 0 0 1001 0 13 0 0 0 0
0 0 0 11 0 13 0 17 0 1002 0 12 0 0 0 0
0 0 0 0 0 0 0 0 0 0 0 0 0 0 0 0
0 1000 0 1000 0 1013 0 1000 0 16 0 1000 0 0 0 0
0 0 17 0 10 0 0 0 0 0 0 0 0 0 0 0
0 1000 0 1000 0 1000 0 1000 0 17 0 1000 0 0 0 0
0 0 0 0 0 0 0 0 0 0 0 0 0 0 0 0
0 0 0 0 0 11 0 13 0 1003 0 0 0 0 0 0
0 12 0 12 0 1001 0 10 0 1001 0 1 0 0 0 0
0 0 13 0 0 1001 0 1003 0 1001 0 1008 0 0 0 0
0 0 0 0 0 0 0 0 0 0 0 0 0 0 0 0