0 0 0 0 0 0 0 0 0 0 0 0 0 0 0 0
0 0 0 0 0 0 0 0 0 0 0 0 0 0 0 0
0 0 0 0 0 0 0 0 0 0 0 0 0 0 0 0
0 16 16 16 0 0 0 0 0 16 16 16 0 0 0 0
0 0 17 0 0 0 17 0 0 0 17 0 0 0 0 0
0 0 0 0 0 0 0 0 0 0 0 0 0 0 0 0
0 16 1005 16 0 0 0 0 0 16 1004 16 0 0 0 0
0 0 17 0 0 0 0 0 0 0 17 0 0 0 0 0
0 0 0 0 0 0 0 0 0 0 0 0 0 0 0 0
0 1000 0 1000 0 0 0 0 0 1000 0 1000 0 0 0 0
0 1 0 0 0 0 0 0 0 0 0 0 0 0 0 0
0 1008 0 0 10 0 0 0 10 0 0 1003 0 0 0 0
0 0 0 0 0 0 0 0 0 0 0 0 0 0 0 0
