0 0 0 0 0 0 0 0 0 0 0 0 0 0 0 0
0 1001 1005 0 1001 1003 1001 0 0 0 0 1002 0 0 0 0
0 0 1002 0 1003 1001 1003 0 0 1001 11 0 0 0 0 0
0 10 0 0 1001 1003 1001 0 0 0 0 0 0 0 0 0
0 1000 0 0 0 0 0 0 0 0 0 1011 0 0 0 0
0 0 0 11 0 0 0 12 0 0 0 0 0 0 0 0
0 1000 0 0 0 0 0 0 0 0 0 0 0 0 0 0
0 16 0 0 0 0 0 0 0 0 0 1002 0 0 0 0
0 0 1001 0 0 0 0 0 0 1000 10 1001 0 0 0 0
0 1002 1004 0 0 0 0 0 0 0 0 0 0 0 0 0
0 0 0 0 0 0 0 0 13 0 0 0 0 0 0 0
0 1008 1 0 0 0 0 0 0 1000 0 1007 0 0 0 0
0 0 0 0 0 0 0 0 0 0 0 0 0 0 0 0