0 0 0 0 0 0 0 0 0 0 0 0 0 0 0 0
0 1007 0 0 13 1000 0 0 0 0 1000 0 0 0 0 0
0 0 0 0 0 0 1001 0 12 12 0 13 0 0 0 0
0 0 1000 11 0 0 0 0 1001 1001 0 0 0 0 0 0
0 0 0 0 1000 0 11 0 1001 1001 0 0 0 0 0 0
0 1001 0 10 0 0 0 0 0 0 0 0 0 0 0 0
0 1001 0 0 11 0 0 12 0 0 0 0 0 0 0 0
0 0 17 0 0 0 0 0 0 0 0 13 0 0 0 0
0 0 0 0 0 0 12 0 0 0 0 0 0 0 0 0
0 1005 1001 1002 0 0 0 0 1000 0 0 0 0 0 0 0
0 0 0 0 0 0 0 0 0 0 0 0 0 0 0 0
0 1008 1 0 0 0 0 0 0 0 0 0 0 0 0 0
0 0 0 0 0 0 0 0 0 0 0 0 0 0 0 0