0 0 0 0 0 0 0 0 0 0 0 0 0 0 0 0
0 1008 0 1000 1000 0 1007 0 0 1001 0 1001 0 0 0 0
0 1 0 0 0 0 0 12 0 0 0 0 0 0 0 0
0 1000 0 0 0 0 1000 0 0 1003 0 1002 0 0 0 0
0 0 0 1001 1001 1001 0 0 0 0 0 0 0 0 0 0
0 1002 0 0 0 0 0 10 0 0 0 0 0 0 0 0
0 0 13 12 13 0 0 0 0 0 0 0 0 0 0 0
0 0 0 0 0 1000 0 11 0 0 1000 0 0 0 0 0
0 0 0 0 11 0 16 0 10 0 0 0 0 0 0 0
0 1000 0 0 0 0 0 0 0 0 0 1000 0 0 0 0
0 12 0 0 1004 1001 0 1014 1002 0 0 16 0 0 0 0
0 0 11 1013 1001 1005 0 1001 0 1000 17 0 0 0 0 0
0 0 0 0 0 0 0 0 0 0 0 0 0 0 0 0