0 0 0 0 0 0 0 0 0 0 0 0 0 0 0 0 
0 1008 0 1013 0 0 0 0 0 0 0 0 0 0 0 0 
0 0 0 0 0 0 18 0 18 0 0 0 0 0 0 0 
0 0 0 0 0 0 0 0 0 0 0 0 0 0 0 0 
0 0 0 1001 1001 0 0 0 0 0 0 1011 0 0 0 0 
0 0 0 1001 0 1009 0 0 0 1009 0 0 0 0 0 0 
0 0 0 0 0 0 0 0 0 0 0 0 0 0 0 0 
0 0 0 1010 0 0 0 0 0 0 0 1012 0 0 0 0 
0 0 0 0 0 1009 0 0 0 1009 0 0 0 0 0 0 
0 0 0 0 0 0 0 0 0 0 0 0 0 0 0 0 
0 1 0 1003 1003 0 0 0 0 0 0 0 0 0 0 0 
0 1007 0 1003 0 1009 0 0 0 1009 0 0 0 0 0 0 
0 0 0 0 0 0 0 0 0 0 0 0 0 0 0 0 
