0 0 0 0 0 0 0 0 0 0 0 0 0 0 0 0 
0 1007 1 0 0 0 0 0 0 0 0 0 0 0 0 0 
0 0 0 0 0 0 0 0 0 0 0 0 0 0 0 0 
0 1002 0 0 1000 0 0 1004 1001 0 0 0 0 0 0 0 
0 0 16 0 0 0 0 1005 1002 0 0 0 0 0 0 0 
0 0 1000 0 0 0 0 0 0 1000 0 0 0 0 0 0 
0 1001 0 0 0 0 1000 11 10 11 0 0 0 0 0 0 
0 0 17 0 0 0 0 0 0 0 0 0 0 0 0 0 
0 0 1000 0 0 0 0 0 0 0 0 0 0 0 0 0 
0 0 0 0 0 0 0 0 0 0 1000 0 0 0 0 0 
0 1002 0 1001 0 0 0 0 0 0 11 0 0 0 0 0 
0 1002 0 1001 0 0 0 0 0 12 1003 12 0 0 0 0 
0 0 0 0 0 0 0 0 0 0 0 0 0 0 0 0 
